# - # => line are comments and will not be considered
# - M => line contains MAP INFO [0 means empty space 1 to 8 means wall with diff textures 9 means door]
# - P => line contains player position in cells [x y]
# - C => line contains cell size (square)
# - S => line contains player size (scaling)
# - N => line contains minimap size in cells
# - 

C 32

P 1 1

S 10

N 5

M 111111111111111111111111
M 100000000011000000000001
M 101100000111000000000001
M 100100000000000000000001
M 101100000111000000000001
M 100000000011000001110111
M 111101111111111111000001
M 111101111010101011010101
M 110000001101010111000001
M 100000000000000011000001
M 100000000000000011010101
M 110000001101010111110111
M 111101111111011111110111
M 111101111111001011000001
M 110000011100000011000001
M 100000001100000011000001
M 100000001111111011100011
M 100000001111111110010101
M 110000011100011010100011
M 100000001000001101010101
M 100000000000000000000001
M 100000001000001101010101
M 110000011100011010100011
M 111111111111111111111111
