# - # => line are comments and will not be considered
# - M => line contains MAP INFO [0 means empty space, 1 to 5 means wall with diff textures, 6 means door]
# - P => line contains player position in cells [x y]
# - C => line contains cell size (square)
# - S => line contains player size (scaling)
# - N => line contains minimap size in cells
# - T => line contains texture path

C 32

P 2 2

S 10

N 5

M 111111111111111111111111111111
M 100011000111100000000000000001
M 100000010111110111111111111111
M 100011110000000111111111111111
M 111111111111110000000000000001
M 111000000000011000000000000011
M 111011111111011110000000001111
M 111011000011011111111001111111
M 111011000011011111111001100001
M 111011100111011111111001100001
M 111011100111000000000011100001
M 111011100111111111111111100001
M 111000000000000000000000001111
M 111111111111111111110001111111
M 111111001111111111110001111111
M 111111001110000011110001111111
M 111111001110000011111100111111
M 111111001110000011110001111111
M 111111001110000011110001111111
M 111111001110111011110111111111
M 111111001110111011110001110001
M 111111001110111011111101110001
M 111111000000111011110001110001
M 111111001111111011110111110001
M 111111001111111011110000001111
M 111111101111111011111001111111
M 111111001111111011110101111111
M 111111101111111011110001111111
M 111111000000000000000001111111
M 111111111111111111111111111111
