# - # => line are comments and will not be considered
# - M => line contains MAP INFO [0 means empty space, 1 to 5 means wall with diff textures, 6 means door]
# - P => line contains player position in cells [x y]
# - C => line contains cell size (square)
# - S => line contains player size (scaling)
# - N => line contains minimap size in cells
# - T => line contains texture path

C 32

P 3 2

S 10

N 5

M 111111111111111111111111111111
M 100000000011000000000000000001
M 100000000111001111011100100001
M 100000010000001001010100100001
M 100100010111001000010100100001
M 100000000011000001110110110111
M 111101111111111111000000000001
M 111101111010101011011100100001
M 110001001101010111001001001001
M 100111000100010011100011011111
M 100010010001000011000100100001
M 110000001101010111110111111111
M 111101111111011111110111111111
M 111101111111001011000000000001
M 110000011100010011001000000001
M 100010001001000111000000000001
M 100110000011111011100011011111
M 100010001011111110010100100001
M 110000011000011010100011011111
M 111111111111111111111111111111

