# - # => line are comments and will not be considered
# - M => line contains MAP INFO [0 means empty space, 1 to 5 means wall with diff textures, 6 means door]
# - P => line contains player position in cells [x y]
# - C => line contains cell size (square)
# - S => line contains player size (scaling)
# - N => line contains minimap size in cells

C 32

P 28 23

S 10

N 5

M 111111111111111111111111111111
M 100000000000001000000011000001
M 101011111010000000111000000011
M 101010000010001101100011110011
M 101011111110001001000011111001
M 100000000000001001110011101101
M 100000000000001001000011100001
M 101110011111111001011111101101
M 100010010000000001010011101001
M 100010010011001111010011101111
M 100010010000000001000000000001
M 111110011111100001101100010111
M 100010010000100001000101010001
M 100000000000111001010111010101
M 100010010000001001010100010101
M 111110011111001001010101010101
M 100000000001001101000101010001
M 100011110001000001111100111111
M 101000000001000001000000000001
M 101011110001000111000000000001
M 100110010101111000000011100001
M 110000010100000011000011100001
M 110010010101111000000011100001
M 100010010001000000110000000001
M 111111111111111111111111111111



